ואימא פרזים בי"ד - דהא קבעינהו קרא אבל מוקפין דלא קבעינהו קרא אי בעו בארביסר ליקרו אי בעו בחמיסר ליקרו:
מדרבי יוסי בר חנינא - דדריש משפחה כו
שפצינהו - החזיק את בדקיהן ודומה לו ביבמות (דף סג.) טום ולא תשפץ שפיץ ולא תבנה:
אעבור פרשתא הדא ואתניה - אסיים פרשה זו ואשנה אותה פעם שניה:
סידרא דירחא - דקתני בי"א בי"ב בי"ג בי"ד בט"ו כסדר מנין החודש וכשבא לפרשה נקט סדר ימי השבת ושמעינן ימי החודש לאחריה חל להיות ערב שבת כפרים מקדימין ליום הכניסה הרי י"ג חל להיות בשבת הרי י"ב חל להיות אחר השבת כפרים מקדימין ליום הכניסה הרי י"א ומשני איידי דמיתהפכי ליה נקט סידורא דיומי כלומר ע"י שאם היה אוחז ימי השבת לפי סדר ימי החדש יהו נהפכין לו וטועה בגירסתו השונה את המשנה לפי שהיה צריך להזכירן לאחוריו אחר השבת דהיינו י"א בשבת י"ב ערב שבת י"ג מתוך כך הוא בא לדלג ולטעות להכי נקט סידורא דיומא וסדר החודש הבא לו לאחוריים אינו מזכירו בפיו דהרי מאליו הוא נשמע ואין כאן עוד טעות:
בכל שנה ושנה - להיות עושים את שני הימים האלה ככתבם וכזמנם בכל שנה ושנה כל השנים יהו שוות:
דלא אפשר - דאם כן לא יקדמו עיירות למוקפין שאינן יכולין לקרות בשבת:
מה כל שנה ושנה עיירות בי"ד - לכך אין נדחות ממקומן ודלא כתנא קמא דרבי:
דלא אפשר - דאי לא מקדמת להו למוקפין צריך אתה לעקור עיירות מפני מוקפין או יקראו ביום אחד:
גובין בו ביום - שמקדימין בו לקרות גובין הגבאים מתנות האביונים ומחלקין לעניים:
ערב שבת זמנם הוא - משמע שהוא זמן הקבוע להו מימי אנשי כנסת הגדולה מדלא קאמר מקדימין לערב שבת להכי קשה ליה והא שבת זמנם הוא שהרי י"ד הוקבע לפרזים אלא להכי נקט האי לישנא דתשמע מינה הואיל ותיקנו להן חכמי ישראל שאחר כנסת הגדולה להקדים משום דרבה הרי הוא לנו כיום וזמן הקבוע מתחלה לכל דבריו ואף על פי שהוא שלא בזמנן הוי כזמנן:
ולא מקדימין - טעמא מפרש בגמרא:
כל זמן חגיגה - כל הרגל עד י"ט האחרון רשאי לשהותה:
שדי כיתנא - זורע פשתן:
יושבי רקת צאו וקבלו הרוגי עמק - מתי בבל העמוקה:
שאסורין בזה ובזה - ביום ארבעה עשר וחמשה עשר שבשניהן:
אינה מטמאה את הידים - כשאר ספרים דאמר ביציאות השבת (דף יד.) שגזרו עליהן לטמא את הידים לתרומה ומחלוקת בית שמאי וב"ה היא:
הכי גרסינן אחר הדברים האלה גדל המלך את המן וגו' - בתר בגתן ותרש כתיב:
הכי גרסי' זאת מכלל דאיכא אחריתי ומאי ניהו מעשה דבת שבע ומסקנא הכי הוה – והכי פירושה מדקאמרה ליה ולא תהיה זאת לך לפוקה מכלל שהתנבאת' לו שסופו להכשל בביאה אחרת ומאי ניהו בת שבע ומסקנא הכי הוה סוף שעלתה לו כך אלמא נביאה הוות שנתקיימה נבואתה:
כלו הפושעים - שאינם מאמינין בדת משה שהיתה מן השמים לכך סמכו לה ברכת הפושעים שנאמר עוזבי ה' אלו הפושעים ושבר פושעים היינו זדים כדאמר פשעים אלו המרדין (יומא דף לו:):
מדסיפא רבי יהודה - דקתני ור' יהודה מכשיר בקטן:
מן המתיר - ר' יהודה שקרית לפניו הוא המתיר את הקטן ואין לך להביא ראיה ממנו שהרי רבים חולקין עליו:
מתני' ולא טובלין - משיגיע שביעי לזב ולטמא מת אין אומרים משחשיכה בכניסת שביעי ראוי לטבול אע"ג דלילה תחילת יום היא הכא יום בעינן אבל משעבר היום מותר לטבול בלילה ובגמרא יליף לה לכולהו:
קמ"ל - כיון דהאי אחד לאחד משום ספירה היא מדוגמת ספירת ז' כל ספירה דיממא היא דכתיב וספרה לה שבעת ימים (ויקרא טו):
ואין מפטירין - משום האי טעמא גופיה:
ואדם כיוצא בהן - אם בא לפדות מיד הקדש ובגמ' מפרש לה:
למחראות - גבי עבודת כוכבים כתיב בספר מלכים כי חור לשון מוצא ריעי הוא:
תני ישהה - כדי הילוך ארבע אמות:
(בחניכתו) - אם כינו שם לחבירו לגנאי:
הכי גרסינן כי היכי דלא ליקדום עשייה לזכירה:
איזו היא שבת שלישית - שקורין בו פרשה שלישית:
ובתעניות למה לי הפסקת - פרשיות לרבי ירמיה פריך דאמר היכא דאפשר לא מפסקינן תעניות כיון דאיכא קריאה במנחה למה יפסקו שחרית:
